TILEMAP
32 20
8 8
images/tilesetGoonies.png

1 2 3 4 7 10 4 2 3 7 5 6 4 10 10 2 3 4 7 2 3 4 7 10 4 5 6 4 10 4 10 11 
45 0 199 200 201 0 0 16 17 0 0 0 0 0 0 0 0 0 0 79 80 81 0 0 0 16 17 0 0 0 0 22 
12 0 210 211 212 0 0 0 0 0 0 0 0 0 0 129 130 131 0 90 91 92 0 0 0 0 0 0 0 0 0 33 
34 0 221 222 223 0 0 0 0 0 0 0 0 0 0 140 137 142 0 0 139 0 0 0 0 0 0 0 0 0 0 55 
67 72 232 233 234 72 72 72 144 0 0 0 149 152 152 151 152 153 152 152 150 144 0 0 0 0 0 0 0 0 0 22 
1 7 2 3 8 7 4 7 155 0 0 0 55 88 99 88 88 88 99 88 88 12 0 0 0 0 0 0 0 0 0 33 
45 0 0 0 19 0 0 0 0 0 0 0 22 99 99 88 88 99 88 88 99 23 0 0 0 0 0 0 0 0 0 22 
12 0 0 0 19 0 0 0 0 0 0 0 66 88 88 88 99 88 88 99 88 56 0 0 0 0 0 199 200 201 0 22 
34 35 36 37 19 199 200 201 0 0 0 0 0 2 3 10 7 4 10 4 106 0 0 0 0 0 0 210 211 212 0 55 
12 46 47 48 19 210 211 212 0 0 0 0 0 0 0 0 0 0 0 0 106 0 0 0 0 0 0 221 222 223 0 22 
45 57 58 59 19 221 222 223 0 0 0 0 0 0 0 0 0 0 0 0 106 15 0 0 0 149 72 232 233 234 72 77 
67 68 69 70 74 232 233 234 72 144 0 0 0 0 129 130 131 0 0 0 106 0 0 0 0 160 8 2 3 4 7 11 
1 7 4 7 2 3 4 7 8 155 0 0 0 0 140 137 142 0 0 0 117 0 0 0 0 0 19 0 0 0 0 22 
45 0 0 0 0 0 0 0 63 0 0 0 149 72 151 152 153 72 72 72 150 72 144 0 0 0 19 0 0 0 0 22 
12 0 0 0 0 0 0 0 63 0 0 0 160 4 5 6 7 4 10 2 106 4 155 0 0 0 19 0 0 0 0 33 
34 0 0 0 0 0 0 0 63 0 0 0 0 0 16 17 0 0 0 0 128 127 127 127 128 0 19 0 0 0 0 55 
12 0 199 200 201 0 0 0 63 0 0 0 0 0 0 0 0 0 0 0 106 0 0 0 139 0 19 35 36 37 0 22 
45 0 210 211 212 0 0 0 63 0 0 129 130 131 0 0 0 0 0 0 106 0 0 0 139 0 19 46 47 48 0 55 
45 0 221 222 223 0 0 0 63 0 0 140 137 142 0 0 0 0 0 0 106 137 0 0 117 0 19 57 58 59 0 22 
67 72 232 233 234 72 72 72 74 72 72 151 152 153 72 72 72 72 144 0 106 0 149 72 150 72 74 68 69 70 72 77