TILEMAP
32 20 
16 16 
images/tilesetGoonies.png 
16 16 
1 4 5 6 9 4 7 4 5 6 4 9 7 4 5 6 4 9 15 1 4 5 6 129 7 5 6 4 9 4 7 15 
49 0 18 19 20 0 0 0 0 0 0 0 0 0 25 26 27 0 31 17 28 29 30 129 0 0 0 0 0 0 0 31 
17 0 34 35 36 0 0 0 0 0 0 0 0 0 41 42 43 0 47 33 44 45 46 129 0 0 0 0 0 0 0 47 
33 0 50 51 52 0 0 0 0 0 0 0 0 0 57 58 59 0 63 49 60 61 62 129 0 0 0 0 0 0 0 63 
65 67 66 67 68 67 67 146 0 0 0 0 151 67 73 74 75 67 79 65 76 77 78 145 146 147 148 149 150 151 67 79 
1 4 5 6 8 7 9 162 0 0 0 0 167 5 6 4 5 6 7 4 5 6 4 129 162 163 164 165 166 167 8 15 
33 0 0 0 24 0 0 0 0 0 0 0 0 0 0 0 0 0 0 0 0 0 0 129 0 0 0 0 0 0 24 31 
17 0 0 0 24 0 0 0 0 0 0 0 0 0 0 0 0 0 0 0 0 0 0 129 0 0 0 0 0 0 24 63 
17 28 29 30 24 0 0 0 151 146 0 0 0 0 0 0 37 38 39 0 0 0 0 129 0 0 0 0 151 67 72 79 
33 44 45 46 24 0 0 0 167 162 0 0 0 0 0 0 53 54 55 0 0 0 0 113 0 0 0 0 167 5 6 7 
49 60 61 62 24 0 0 0 0 83 84 85 0 0 0 151 69 70 71 67 67 67 67 145 146 83 84 85 0 0 0 0 
65 76 77 78 72 67 67 0 0 99 100 101 98 98 98 98 98 98 98 98 98 97 98 97 98 99 100 101 0 0 0 0 
1 4 8 7 5 6 162 0 0 151 146 0 0 0 0 0 0 0 0 0 0 129 0 0 0 0 0 0 0 0 0 0 
17 0 24 0 0 0 0 0 0 167 162 0 0 0 0 0 0 0 0 0 0 129 0 0 0 0 0 0 151 67 67 67 
33 0 24 0 0 0 0 0 0 0 0 0 0 0 0 0 0 0 0 0 0 129 0 0 0 0 0 0 167 7 4 15 
65 67 72 67 146 0 0 0 0 0 0 0 0 151 146 0 0 0 0 0 0 129 0 0 0 0 0 0 37 38 39 31 
1 5 6 4 162 0 0 151 67 146 0 0 0 167 162 0 0 0 0 0 0 113 0 0 0 0 0 0 53 54 55 63 
49 0 0 0 0 0 0 167 9 162 0 0 0 0 0 0 0 0 0 0 151 145 67 67 67 67 67 67 69 70 71 79 
93 93 93 93 94 94 94 93 93 94 94 93 93 93 93 94 93 93 94 94 95 96 95 96 95 96 95 96 95 96 95 96 
94 94 94 93 93 93 94 93 94 93 93 94 93 93 93 93 93 94 93 94 94 93 94 94 94 93 94 93 93 94 94 94

1 4 5 6 7 8 9 17 33 49 64 65 80 162 -1

4 5 6 7 8 9 15 31 47 63 64 79 80 167 -1

64 65 66 67 68 69 70 71 72 73 74 75 76 77 78 79 80 102 103 146 147 148 149 150 151 93 94 -1

1 4 5 6 7 8 9 15 64 80 162 167 -1 

24 72 -1

8 24 -1

61 -1





