TILEMAP
32 20 
16 16 
images/tilesetGoonies.png 
16 16 
1 4 5 6 7 4 5 6 4 7 5 6 9 9 4 5 6 7 4 4 9 5 6 4 5 6 7 9 4 5 6 15 
17 0 0 0 0 0 0 0 0 0 0 83 84 85 83 84 85 0 0 0 0 0 0 0 0 0 0 25 26 27 0 31 
33 0 37 38 39 0 0 0 0 0 0 99 100 101 99 100 101 0 0 0 0 0 0 0 0 0 0 41 42 43 0 47 
49 0 53 54 55 0 0 0 0 0 0 0 0 0 0 0 0 0 0 0 0 0 0 0 0 0 0 57 58 59 0 63 
65 67 69 70 71 67 67 146 0 0 0 0 0 0 0 0 0 151 67 67 67 67 67 67 67 67 67 73 74 75 67 79 
1 7 4 5 6 4 9 162 0 0 0 0 0 0 0 0 0 167 7 8 5 6 4 5 6 7 4 5 6 4 7 15 
17 0 0 0 0 0 0 0 0 0 0 0 0 0 0 0 0 0 0 24 0 0 0 0 0 0 0 0 0 0 0 31 
33 0 0 0 0 0 0 0 0 0 0 0 0 0 0 0 0 0 0 24 0 0 0 0 0 0 0 0 0 0 0 47 
49 0 0 0 0 0 0 0 0 0 0 0 37 38 39 0 0 0 0 24 0 0 0 0 0 0 0 0 0 0 0 63 
162 0 0 0 0 0 0 0 0 0 0 0 53 54 55 0 0 0 0 24 0 0 0 0 0 0 0 0 0 0 0 47 
0 0 0 0 0 0 0 0 0 0 0 151 69 70 71 146 0 0 0 24 0 0 0 0 0 0 0 28 29 30 0 31 
0 0 0 0 0 0 0 0 0 0 0 167 5 6 7 162 0 0 0 24 0 0 0 0 0 0 0 44 45 46 0 47 
0 0 0 0 0 0 0 0 0 0 0 0 0 0 0 0 0 0 0 24 0 0 0 0 0 0 0 60 61 62 0 63 
67 67 67 67 67 67 67 67 146 0 0 0 0 0 0 0 0 0 0 24 0 0 151 67 67 67 67 76 77 78 67 79 
1 4 5 6 7 9 5 6 162 28 29 30 0 0 0 0 0 0 0 24 0 0 167 5 6 7 9 4 7 9 4 15 
17 37 38 39 0 0 0 0 0 44 45 46 0 0 0 0 0 0 0 0 0 0 0 0 0 0 0 0 0 0 0 31 
33 53 54 55 0 0 0 0 0 60 61 62 0 0 0 0 0 0 0 0 0 0 0 0 0 0 0 0 0 0 0 47 
65 69 70 71 67 67 67 67 67 76 77 78 146 0 0 0 0 0 0 0 0 0 0 0 0 0 0 0 0 0 0 79 
95 95 96 95 96 96 95 96 96 96 96 95 96 93 93 94 93 94 93 94 94 93 93 94 93 93 94 93 94 93 93 95 
94 93 94 93 93 94 93 93 94 94 94 93 94 93 94 93 94 93 93 93 94 94 93 93 94 94 93 93 94 93 94 94

1 4 5 6 7 8 9 17 33 49 64 65 80 162 -1

4 5 6 7 8 9 15 31 47 63 64 79 80 167 -1

64 65 66 67 68 69 70 71 72 73 74 75 76 77 78 79 80 102 103 146 147 148 149 150 151 93 94 -1

1 4 5 6 7 8 9 15 64 80 162 167 -1 

24 72 -1

8 24 -1

61 -1





