TILEMAP
32 20 
16 16 
images/tilesetGooniesBlue.png 
16 16 
1 4 5 6 7 4 5 129 4 7 9 5 6 4 9 5 6 4 7 5 6 9 5 6 4 7 9 4 5 6 4 15 
49 0 0 0 0 0 0 129 0 0 0 0 0 0 0 0 0 0 0 0 0 0 0 0 0 0 0 0 28 29 30 31 
17 0 0 0 0 0 0 129 0 0 0 0 0 0 0 0 37 38 39 0 0 0 0 0 0 0 0 0 44 45 46 47 
33 0 0 0 0 0 0 129 0 0 0 0 0 0 0 0 53 54 55 0 0 0 0 0 0 0 0 0 60 61 62 63 
49 0 0 0 0 0 0 113 0 0 0 0 0 0 0 151 69 70 71 67 146 147 148 149 150 151 67 67 76 77 78 79 
65 67 67 67 67 67 146 129 0 0 0 54 0 0 0 167 5 6 9 7 162 163 164 165 166 167 4 5 6 9 7 15 
1 4 9 5 6 8 162 129 0 148 149 148 148 150 0 0 0 0 0 0 0 0 0 0 0 0 0 0 0 0 0 47 
17 18 19 20 0 24 0 129 0 163 164 164 165 166 0 0 0 0 0 0 0 0 0 0 0 0 0 0 18 19 20 31 
33 34 35 36 0 24 0 129 0 0 0 0 0 0 0 0 0 0 0 151 146 0 0 0 0 0 0 0 34 35 36 47 
49 50 51 52 0 24 0 129 0 0 0 0 0 0 37 38 39 0 0 15 1 0 0 0 0 0 0 0 50 51 52 63 
65 66 67 68 67 72 67 145 67 146 0 0 0 0 53 54 55 0 0 31 17 0 0 0 0 0 0 151 66 67 68 79 
1 4 5 6 4 5 6 129 7 4 0 0 0 151 69 70 71 146 0 47 33 0 0 0 0 0 0 167 9 9 8 15 
49 0 0 0 0 0 0 129 0 0 0 0 0 167 9 8 9 162 0 31 65 67 67 146 0 0 0 0 113 0 24 47 
17 28 29 30 0 0 0 97 97 98 98 98 98 97 0 24 0 0 0 47 1 8 7 162 0 0 0 0 129 0 24 31 
33 44 45 46 0 0 0 0 129 0 0 0 0 113 0 24 0 0 0 31 49 24 97 98 98 98 98 98 97 0 24 63 
49 60 61 62 0 0 0 0 129 0 0 0 0 129 0 24 0 0 0 47 33 24 129 0 0 0 0 0 129 0 24 31 
65 76 77 78 146 0 0 0 129 0 0 0 0 129 0 24 0 0 0 63 49 24 129 0 0 0 0 0 129 0 24 47 
64 80 64 64 80 67 146 0 113 0 0 0 0 129 0 24 0 0 0 47 33 24 113 0 0 0 0 0 129 0 24 47 
64 80 64 80 64 80 80 67 145 67 67 146 0 129 0 24 0 0 0 63 49 24 129 0 0 0 0 0 113 0 24 31 
80 64 80 80 64 64 64 80 64 80 64 1 0 129 0 24 0 0 0 47 33 24 129 0 0 0 0 0 129 0 24 63

1 4 5 6 7 8 9 17 33 49 64 65 80 162 -1

4 5 6 7 8 9 15 31 47 63 64 79 80 167 -1

64 65 66 67 68 69 70 71 72 73 74 75 76 77 78 79 80 102 103 146 147 148 149 150 151 93 94 -1

1 4 5 6 7 8 9 15 64 80 162 167 -1 

24 72 -1

8 24 -1

61 -1





