TILEMAP
32 20 
16 16 
images/tilesetGooniesPurple.png 
16 16 
64 64 64 64 64 64 64 64 64 64 64 64 80 80 80 80 1 4 5 6 9 5 6 7 4 8 5 6 7 5 6 15 
80 64 64 64 80 80 80 80 80 80 80 80 80 6 5 6 37 38 39 0 0 0 0 0 0 24 0 0 18 19 20 31 
64 64 64 80 80 80 80 80 80 6 4 9 4 0 0 0 53 54 55 0 0 0 0 0 0 24 0 0 34 35 36 47 
80 80 80 80 1 4 4 5 6 0 0 0 0 0 0 149 69 148 71 149 0 0 0 0 0 24 0 0 50 51 52 63 
1 4 5 6 0 0 0 0 0 0 0 0 0 0 0 167 164 166 8 164 0 0 0 0 0 24 149 150 66 67 68 79 
17 0 0 0 0 0 0 0 0 0 0 0 0 0 0 0 0 0 24 0 0 0 0 0 0 24 166 4 5 6 7 9 
33 28 29 30 0 0 0 0 0 0 0 0 0 0 0 0 0 0 24 0 83 84 85 0 0 24 0 0 0 0 0 0 
17 44 45 46 0 0 0 0 0 97 98 98 98 98 98 98 98 98 24 98 99 100 101 98 98 24 98 98 97 0 0 0 
33 60 61 62 0 0 0 0 0 113 0 147 149 148 148 149 150 0 24 0 0 0 0 0 0 24 0 0 129 0 0 0 
65 76 149 78 149 149 149 146 0 129 0 8 163 166 164 165 166 0 24 0 0 0 0 37 38 39 0 0 129 0 0 0 
9 7 5 6 4 163 165 163 0 129 0 0 0 0 0 0 0 0 24 0 0 0 0 53 54 55 0 0 113 0 147 67 
0 0 0 0 0 0 0 0 0 129 37 38 39 0 0 0 0 0 24 0 0 0 148 69 149 71 146 0 129 0 167 9 
0 0 0 0 0 0 0 0 0 113 53 54 55 0 0 0 0 0 0 0 0 0 163 166 7 165 162 0 97 98 98 98 
0 0 0 0 0 0 0 0 0 129 69 148 71 0 0 0 0 0 0 0 0 0 0 0 0 0 0 0 0 0 0 0 
149 148 149 150 0 0 0 0 0 129 163 166 165 0 0 0 18 19 20 0 0 0 0 0 0 0 28 29 30 0 0 0 
164 164 165 166 0 0 0 0 0 129 0 0 0 0 0 0 34 35 36 0 0 0 0 0 0 0 44 45 46 0 0 0 
0 0 0 0 0 0 0 0 0 129 0 0 0 0 0 0 50 51 52 0 0 0 0 0 0 0 60 61 62 0 0 0 
0 0 0 0 0 0 0 0 0 113 0 0 0 0 0 0 66 148 68 0 0 0 0 0 148 149 76 150 78 146 0 0 
0 0 0 0 0 0 0 0 151 145 148 149 0 0 0 0 163 165 166 0 0 0 0 0 163 164 9 9 165 166 0 0 
94 94 93 94 93 93 94 93 95 96 95 96 94 93 93 94 93 93 94 94 93 94 93 94 94 93 94 93 93 94 94 93

1 4 5 6 7 8 9 17 33 49 64 65 80 162 -1

4 5 6 7 8 9 15 31 47 63 64 79 80 167 -1

64 65 66 67 68 69 70 71 72 73 74 75 76 77 78 79 80 102 103 146 147 148 149 150 151 93 94 -1

1 4 5 6 7 8 9 15 64 80 162 167 -1 

24 72 -1

8 24 -1

61 -1





