TILEMAP
36 24 							-- Size of tile map in tiles
16 16 							-- Tile size & block size
images/tilesetGoonies.png 	-- Tilesheet
10 14 								-- Number of tiles in tilesheet
51 52 51 51 51 51 51 51 51 51 51 51 51 51 51 51 51 51 51 51 51 51 51 51 51 51 51 51 51 51 51 51 51 51 51 52 
51 52 51 51 51 51 51 51 51 51 51 51 51 51 51 51 51 51 51 51 51 51 51 51 51 51 51 51 51 51 51 51 51 51 51 52 
51 52 1 4 2 3 4 7 2 3 7 4 9 2 3 4 7 9 10 1 4 2 3 9 4 2 3 9 4 7 2 3 7 10 51 52 
51 52 11 101 102 103 0 12 13 14 0 0 0 0 0 104 105 106 20 11 107 108 109 0 77 0 0 0 0 0 0 0 0 20 51 52 
51 52 21 111 112 113 0 22 23 24 0 0 0 0 0 114 115 116 30 21 117 118 119 0 77 0 0 0 0 0 0 0 0 30 51 52 
51 52 31 121 122 123 0 32 33 34 0 0 0 0 0 124 125 126 40 31 127 128 129 0 67 0 0 0 0 0 0 0 0 40 51 52 
51 52 41 131 46 133 46 42 43 44 81 0 0 0 86 134 135 136 50 41 137 138 139 81 77 0 0 0 86 46 46 46 46 50 51 52 
51 52 1 9 7 4 8 5 6 4 91 0 0 0 96 4 7 8 10 1 7 4 9 91 77 68 69 70 96 7 10 1 8 10 51 52 
51 52 11 0 0 0 28 0 0 0 0 0 0 0 0 0 0 28 20 11 0 0 0 0 77 78 79 80 0 0 20 11 28 20 51 52 
51 52 21 68 69 70 28 0 0 0 0 0 0 0 0 0 0 28 30 21 0 0 0 0 77 88 89 90 0 0 30 21 28 40 51 52 
51 52 31 78 79 80 28 0 0 0 0 0 0 0 0 0 0 28 40 31 0 101 102 103 77 96 9 91 0 0 55 31 28 30 51 52 
51 52 41 88 89 90 48 46 81 0 0 0 0 0 68 69 70 28 30 21 0 111 112 113 77 0 0 0 0 0 30 11 28 20 51 52 
51 52 1 8 7 4 9 7 91 0 0 0 0 0 78 0 80 28 40 31 0 121 122 123 67 0 0 0 0 0 40 21 28 30 51 52 
51 52 11 28 0 0 0 0 0 0 0 0 0 86 88 89 90 48 50 41 46 131 132 133 87 46 46 46 46 46 50 31 28 40 51 51 
51 52 21 28 0 0 0 61 62 63 0 0 0 96 4 7 2 3 7 9 4 2 3 7 77 9 5 6 4 7 9 0 28 20 51 51 
51 52 41 48 81 0 0 71 72 73 58 58 58 58 57 58 58 58 58 58 58 58 58 58 57 0 0 0 0 0 0 0 28 40 51 52 
51 52 1 91 91 0 0 0 0 0 0 0 0 0 77 0 0 0 0 0 0 0 0 0 77 0 0 0 0 0 0 0 28 40 51 52 
51 52 11 0 0 0 0 86 46 81 0 0 0 0 67 0 0 0 0 0 0 0 0 0 77 0 0 0 0 0 0 0 28 20 51 52 
51 52 21 0 0 0 0 96 4 91 0 0 86 81 77 0 0 0 0 0 0 0 0 0 77 0 0 0 0 0 0 0 28 40 51 52 
51 52 31 0 0 0 0 0 0 0 0 0 96 91 67 0 0 0 0 0 0 0 0 0 67 0 0 0 0 0 0 0 28 40 51 52 
51 52 11 0 0 0 0 0 0 0 0 0 0 0 77 0 86 46 46 46 46 46 46 46 87 46 46 46 46 46 46 46 48 50 51 52 
97 97 98 99 100 99 99 100 99 99 100 100 99 100 99 100 97 97 98 98 97 98 97 98 97 97 98 97 98 97 98 97 97 98 97 98 
99 100 99 99 99 100 99 99 100 99 100 100 99 100 99 99 99 99 99 100 99 99 100 99 99 99 99 99 100 99 100 99 99 99 99 100 
52 52 52 52 52 52 52 52 52 52 52 52 52 52 52 52 52 52 52 52 52 52 52 52 52 52 52 52 52 52 52 52 52 52 52 52

1 2 3 4 5 6 7 8 10 51 52 91 92 93 94 95 96 97 98 -1

10 20 30 40 50 51 52 -1

1 11 21 31 41 51 52 -1

1 2 3 4 5 6 7 10 51 52 91 96 -1 



