TILEMAP
32 20 
16 16 
images/tilesetGooniesPurple.png 
16 16 
1 4 5 6 7 9 5 6 4 7 5 6 9 7 9 5 6 4 7 4 9 5 6 7 5 6 4 9 7 5 6 15 
33 0 18 19 20 0 0 0 0 0 0 0 0 0 0 0 0 0 0 0 0 0 0 0 0 0 0 0 0 0 0 31 
17 0 34 35 36 0 0 0 0 0 0 0 0 0 0 0 0 0 0 0 0 0 0 0 0 0 0 28 29 30 0 31 
33 0 50 51 52 0 0 0 0 0 0 0 0 0 0 0 37 38 39 0 0 0 0 0 0 0 0 44 45 46 0 47 
65 149 66 67 68 148 67 67 149 148 146 0 0 0 0 0 53 54 55 0 0 0 0 0 0 0 0 60 61 62 0 63 
1 7 4 5 6 7 7 8 5 6 162 0 0 0 0 147 69 149 71 148 0 0 0 0 0 148 149 76 149 78 67 79 
33 0 0 37 38 39 0 24 0 0 0 0 0 0 0 163 8 165 165 166 0 0 0 0 0 167 97 7 8 5 6 15 
17 0 0 53 54 55 0 24 0 0 0 0 0 0 0 0 24 0 0 0 0 83 84 85 0 0 129 0 24 0 0 31 
65 148 67 69 149 71 67 72 149 67 148 149 67 146 0 0 24 0 0 0 0 99 100 101 0 0 129 0 24 0 0 47 
1 4 5 6 8 4 5 6 4 5 6 8 4 162 0 0 24 0 0 0 0 0 0 129 0 0 129 0 24 0 0 47 
33 0 0 0 24 0 37 38 39 0 0 24 0 0 0 0 24 0 37 38 39 0 0 129 0 0 113 0 24 0 0 63 
17 0 0 0 24 0 53 54 55 0 0 24 0 0 0 0 24 0 53 54 55 0 0 129 0 0 129 0 24 0 0 0 
65 149 148 149 72 67 69 149 71 148 149 72 148 146 0 0 24 0 69 149 71 0 0 97 98 98 97 0 24 0 0 0 
1 4 5 6 7 9 5 6 4 7 5 6 4 162 0 0 24 0 163 165 166 0 0 129 0 0 0 0 24 0 0 0 
33 0 0 0 0 0 0 0 0 0 0 0 0 0 0 0 24 0 0 0 0 0 0 129 0 0 0 147 148 149 148 149 
17 0 0 18 19 20 0 0 0 0 0 0 0 0 0 0 0 0 0 0 0 0 0 113 0 0 0 163 164 165 165 164 
33 0 0 34 35 36 0 0 0 0 0 0 0 0 0 0 0 0 0 0 0 147 147 145 146 0 0 0 0 0 0 0 
49 0 0 50 51 52 0 0 0 0 0 0 0 0 0 0 0 0 0 0 0 167 9 129 162 0 0 0 0 0 0 0 
65 149 149 66 67 68 67 67 149 148 146 0 0 0 0 151 147 148 0 0 0 0 0 129 0 0 0 0 0 0 0 0 
95 96 95 95 96 96 95 96 95 96 95 93 93 93 94 95 95 96 93 94 94 93 93 94 93 93 94 94 93 94 94 94

1 4 5 6 7 8 9 17 33 49 64 65 80 162 -1

4 5 6 7 8 9 15 31 47 63 64 79 80 167 -1

64 65 66 67 68 69 70 71 72 73 74 75 76 77 78 79 80 102 103 146 147 148 149 150 151 93 94 -1

1 4 5 6 7 8 9 15 64 80 162 167 -1 

24 72 -1

8 24 -1

61 -1





