TILEMAP
32 20 
16 16 
images/tilesetGooniesRed.png 
16 16 
1 5 1 0 0 0 15 6 4 4 9 7 4 5 6 9 4 7 9 7 4 5 6 9 4 5 6 4 4 9 7 15 
17 0 0 0 0 0 0 0 0 0 0 0 0 0 0 0 0 0 0 0 0 0 0 0 0 0 0 0 0 0 0 31 
33 0 0 0 0 0 0 0 0 0 0 0 0 0 0 0 0 0 0 0 0 0 0 0 0 0 0 0 0 0 0 15 
17 18 19 20 0 0 0 0 0 0 0 0 0 0 0 0 0 0 0 0 0 0 0 0 0 0 0 0 0 0 0 0 
33 34 35 36 0 0 0 0 0 0 0 0 0 0 0 0 0 0 0 0 0 37 38 39 0 0 0 0 0 0 0 0 
49 50 51 52 54 0 0 0 0 0 0 0 0 0 0 0 0 0 0 0 0 53 54 55 0 0 0 0 0 0 0 0 
65 66 67 68 70 67 67 67 67 67 67 67 67 67 67 67 67 67 67 67 67 69 70 71 67 67 67 67 67 67 67 67 
1 5 6 7 4 5 6 7 5 6 4 7 9 9 7 4 9 5 6 5 6 4 7 4 5 6 4 7 9 5 6 4 
33 0 0 0 0 0 0 0 0 0 97 98 98 98 98 98 98 98 98 98 98 98 97 0 0 0 0 0 0 0 0 0 
17 0 0 0 0 0 0 0 0 0 129 0 0 0 0 0 0 0 0 0 0 0 129 0 0 0 0 0 0 0 0 0 
33 0 0 37 38 39 0 0 0 0 129 0 0 0 0 0 0 0 0 0 0 0 113 0 0 0 0 0 0 0 0 0 
17 0 0 53 54 55 0 0 0 0 113 0 0 0 0 0 0 0 0 151 67 67 145 67 67 67 67 67 67 67 67 67 
65 67 67 69 70 71 67 67 67 67 145 67 67 67 67 67 67 67 67 64 80 64 64 80 80 64 80 64 80 80 64 80 
1 4 7 5 6 4 7 8 7 4 129 5 6 7 4 5 6 4 162 167 7 5 6 9 4 5 6 7 5 6 9 7 
49 0 0 0 0 0 0 24 0 0 129 0 0 0 0 0 0 0 0 0 0 0 0 0 0 0 18 19 20 0 0 0 
33 0 0 0 0 0 0 24 0 0 129 0 0 0 0 0 0 0 0 0 0 0 0 0 0 0 34 35 36 0 0 0 
49 0 28 29 30 0 0 24 0 0 129 0 0 0 0 0 0 0 0 0 0 0 0 0 0 0 50 51 52 0 0 0 
33 0 44 45 46 0 0 24 0 0 129 0 37 38 39 0 151 67 67 67 67 67 67 67 67 67 66 67 68 67 67 67 
49 0 60 61 62 0 0 24 0 0 129 0 53 54 55 0 15 80 64 64 80 80 64 80 64 80 80 64 80 80 64 80 
65 67 76 77 78 67 67 72 67 67 145 67 69 70 71 67 79 64 80 80 64 80 80 64 80 80 64 80 64 80 80 80

1 4 5 6 7 8 9 17 33 49 64 65 80 162 -1

4 5 6 7 8 9 15 31 47 63 64 79 80 167 -1

64 65 66 67 68 69 70 71 72 73 74 75 76 77 78 79 80 102 103 146 147 148 149 150 151 93 94 -1

1 4 5 6 7 8 9 15 64 80 162 167 -1 

24 72 -1

8 24 -1

61 -1





