TILEMAP
32 20 
16 16 
images/tilesetGooniesBlue.png 
16 16 
1 4 5 6 9 5 6 4 9 7 5 6 4 7 4 15 1 9 4 9 7 5 6 7 4 4 7 5 6 5 6 15 
17 0 18 19 20 0 0 0 0 0 0 0 28 29 30 31 17 0 25 26 27 0 0 0 0 0 0 0 0 0 0 47 
33 0 34 35 36 0 0 0 0 0 0 0 44 45 46 47 33 0 41 42 43 0 0 0 0 0 0 0 18 19 20 31 
49 0 50 51 52 0 0 0 0 0 0 0 60 61 62 63 49 0 57 58 59 0 0 0 0 0 0 0 34 35 36 47 
65 67 66 67 68 67 67 146 0 0 0 151 76 77 78 79 65 67 73 74 75 146 0 0 0 0 0 0 50 51 52 63 
1 7 5 6 9 8 4 162 0 0 0 167 7 8 9 7 15 1 4 5 6 162 0 0 0 0 151 67 66 67 68 79 
17 0 0 0 0 24 0 0 0 83 84 85 0 24 0 0 31 17 0 0 0 0 0 0 0 0 167 9 15 1 8 9 
33 0 37 38 39 24 0 0 0 99 100 101 0 24 0 0 47 33 0 0 0 0 0 0 28 29 30 0 31 17 24 0 
49 0 53 54 55 24 0 0 0 0 129 0 0 24 0 0 31 49 0 37 38 39 0 0 44 45 46 0 47 33 24 0 
65 67 69 70 71 72 67 67 146 0 129 0 0 24 0 0 63 33 0 53 54 55 0 0 60 61 62 0 63 49 24 151 
1 4 8 9 7 5 6 7 162 0 129 0 151 72 67 67 79 65 67 69 70 71 67 67 76 77 78 67 79 49 24 15 
17 0 24 0 0 0 0 0 0 0 129 0 167 5 6 4 7 5 6 4 7 9 5 6 5 6 7 4 9 0 24 63 
49 0 24 0 0 0 0 0 0 0 97 98 98 97 98 98 98 98 98 98 97 98 98 98 98 98 98 98 97 0 24 31 
65 67 72 146 0 0 0 0 0 0 0 0 0 113 0 0 0 0 0 0 129 0 0 0 0 0 0 0 129 0 24 47 
1 9 9 162 0 0 151 67 67 146 0 0 0 129 0 0 0 0 0 0 129 0 0 0 0 0 0 0 129 0 24 63 
17 0 0 0 0 0 167 9 9 162 0 0 0 113 0 0 0 0 0 0 129 0 0 0 0 0 0 0 129 0 24 47 
33 0 0 0 0 0 0 0 0 0 0 0 151 145 146 0 0 0 0 0 129 0 0 37 38 39 0 0 129 0 24 47 
49 0 0 0 0 0 0 0 0 0 0 0 167 129 162 0 0 0 0 0 113 0 0 53 54 55 0 0 113 0 24 63 
65 0 0 0 0 0 0 0 0 0 0 0 0 129 0 0 0 0 0 151 145 67 67 69 70 71 67 67 145 67 72 79 
95 94 94 93 94 93 93 93 93 93 94 93 93 93 93 93 93 94 93 96 95 95 96 95 96 95 95 96 96 95 95 96

1 4 5 6 7 8 9 17 33 49 64 65 80 162 -1

4 5 6 7 8 9 15 31 47 63 64 79 80 167 -1

64 65 66 67 68 69 70 71 72 73 74 75 76 77 78 79 80 102 103 146 147 148 149 150 151 93 94 -1

1 4 5 6 7 8 9 15 64 80 162 167 -1 

24 72 -1

8 24 -1

61 -1





