TILEMAP
32 20 
16 16 
images/tilesetGooniesYellow.png 
16 16 
33 0 0 0 0 129 0 0 47 17 0 0 0 129 0 0 0 24 0 0 0 129 0 47 17 0 0 0 0 0 129 31 
33 0 0 0 0 129 0 0 63 33 0 0 0 129 0 0 0 24 0 0 0 129 0 63 33 0 0 0 0 0 129 63 
17 0 0 0 0 97 98 98 98 98 98 98 98 97 0 0 0 24 0 0 0 129 0 47 17 0 0 0 0 0 129 47 
49 18 19 20 0 0 0 0 47 17 0 0 0 113 0 0 0 24 0 0 0 129 0 47 17 0 0 0 0 0 113 47 
17 34 35 36 0 0 0 0 63 33 0 0 0 129 0 0 0 24 0 0 0 129 0 63 65 67 67 146 0 0 129 63 
49 50 51 52 0 0 0 0 63 49 0 0 0 129 0 0 0 24 0 0 0 129 0 31 1 4 9 162 0 0 129 31 
65 66 67 68 67 146 0 0 0 0 0 0 0 129 0 0 0 24 0 0 0 129 0 63 49 0 0 0 0 0 129 63 
1 4 5 6 7 162 0 0 0 0 0 0 0 113 0 0 0 24 0 0 0 129 0 47 17 0 0 0 0 0 113 47 
98 98 98 98 98 98 98 98 98 97 98 98 98 97 98 98 98 24 98 98 98 97 98 98 98 98 97 98 98 98 97 63 
33 0 0 0 0 0 0 0 0 113 0 0 0 129 0 0 0 24 0 0 0 0 0 31 17 0 129 0 0 0 129 47 
49 0 37 38 39 0 0 0 0 129 0 0 0 129 0 0 0 24 0 18 19 20 0 47 17 0 129 0 151 67 145 79 
17 0 53 54 55 0 0 0 0 129 0 0 0 113 0 0 0 24 0 34 35 36 0 63 17 0 129 0 167 9 5 64 
33 0 69 70 71 0 0 0 0 113 0 0 0 129 151 67 146 24 0 50 51 52 0 47 17 0 129 0 0 0 0 15 
17 0 5 6 7 0 0 0 0 18 19 20 0 129 15 64 1 24 151 66 67 68 67 79 17 0 129 0 0 0 0 63 
17 0 0 0 0 0 0 0 0 34 35 36 0 129 31 64 17 24 167 4 5 6 7 15 17 0 97 98 98 97 0 31 
33 0 28 29 30 0 0 0 0 50 51 52 0 129 47 80 33 24 0 0 0 0 0 63 49 0 0 0 0 129 0 63 
49 0 44 45 46 0 0 0 151 66 67 68 146 129 63 64 49 24 0 0 0 0 0 47 65 67 67 146 0 129 0 47 
17 0 60 61 62 0 0 0 167 7 4 7 162 129 31 64 49 0 0 0 0 0 0 63 1 4 7 162 0 129 0 63 
65 67 76 77 78 146 0 0 0 0 0 0 0 113 47 80 49 0 0 0 0 0 0 31 49 0 0 0 0 113 0 31 
1 9 4 5 6 162 0 0 0 0 0 0 0 129 63 80 33 0 0 0 0 0 0 63 49 0 0 0 0 97 0 63

1 4 5 6 7 8 9 17 33 49 64 65 80 162 -1

4 5 6 7 8 9 15 31 47 63 64 79 80 167 -1

64 65 66 67 68 69 70 71 72 73 74 75 76 77 78 79 80 102 103 146 147 148 149 150 151 93 94 -1

1 4 5 6 7 8 9 15 64 80 162 167 -1 

24 72 -1

8 24 -1

61 -1





