TILEMAP
32 20 
16 16 
images/tilesetGooniesGreen.png 
16 16 
4 5 6 4 9 7 5 6 4 5 6 9 7 5 6 9 7 4 9 5 6 9 7 4 129 5 6 4 5 6 7 15 
0 0 0 0 0 0 0 0 0 0 0 0 0 0 0 0 0 0 0 0 0 0 0 0 129 0 0 0 18 19 20 63 
0 0 37 38 39 0 0 0 0 0 0 0 0 0 0 0 0 0 0 0 0 0 0 0 129 0 0 0 34 35 36 47 
0 0 53 54 55 0 0 0 0 0 0 0 0 0 0 0 0 0 0 0 0 0 0 0 113 0 0 0 50 51 52 63 
67 67 69 70 71 67 67 67 67 67 67 146 0 0 0 147 148 149 150 151 67 67 67 67 145 67 67 67 66 67 68 79 
1 5 6 4 9 7 4 5 6 7 15 1 0 0 0 163 164 165 166 167 4 5 6 7 129 7 4 5 6 7 9 15 
17 0 28 29 30 0 0 0 0 0 31 17 0 0 0 0 0 0 0 0 0 0 0 0 129 0 0 0 0 0 0 31 
33 0 44 45 46 0 0 0 0 0 47 33 0 0 0 0 0 0 0 0 0 0 0 0 129 0 0 0 0 0 0 47 
49 0 60 61 62 0 0 0 0 0 63 65 67 67 146 147 148 149 150 0 0 0 0 0 129 0 0 37 38 39 0 47 
65 67 76 77 78 67 146 0 0 0 31 1 7 4 162 163 164 165 166 0 0 0 0 0 113 0 0 53 54 55 0 31 
5 6 4 9 7 9 162 0 0 0 47 1 0 0 0 0 0 0 0 0 0 0 0 0 129 0 151 69 70 71 67 79 
0 0 0 0 0 0 0 0 0 0 31 33 0 0 0 0 0 0 0 0 0 0 0 0 129 0 9 7 5 6 4 15 
0 0 0 0 0 0 0 0 0 0 47 65 67 67 67 67 67 67 67 67 67 146 0 0 113 0 0 0 0 0 0 47 
0 0 0 0 0 0 0 0 0 0 0 9 4 5 6 7 4 9 5 6 9 162 0 0 129 0 0 0 0 0 0 63 
67 67 67 67 67 67 146 0 0 97 98 98 98 98 98 98 98 98 98 98 98 98 98 98 97 147 148 149 150 0 0 63 
9 4 7 5 6 4 162 0 0 129 0 0 0 0 0 0 0 0 0 0 0 0 0 0 129 163 164 165 166 0 0 31 
98 98 98 98 98 97 98 98 98 97 0 0 18 19 20 0 0 0 0 0 0 0 0 0 113 0 0 0 0 0 0 47 
0 0 0 0 0 129 0 0 0 0 0 0 34 35 36 0 0 0 0 0 151 67 146 0 129 0 0 0 0 0 0 63 
0 0 0 0 0 113 0 0 0 0 0 0 50 51 52 0 0 0 0 0 167 8 162 0 129 0 0 0 151 67 67 79 
67 67 67 67 67 145 67 67 67 67 67 67 66 67 68 67 146 0 0 0 0 24 0 0 129 0 0 0 167 8 9 15

1 4 5 6 7 8 9 17 33 49 64 65 80 162 -1

4 5 6 7 8 9 15 31 47 63 64 79 80 167 -1

64 65 66 67 68 69 70 71 72 73 74 75 76 77 78 79 80 102 103 146 147 148 149 150 151 93 94 -1

1 4 5 6 7 8 9 15 64 80 162 167 -1 

24 72 -1

8 24 -1

61 -1





