TILEMAP
32 20 
16 16 
images/tilesetGooniesYellow.png 
16 16 
1 4 5 6 7 9 7 5 6 4 5 6 129 9 7 4 5 6 9 9 7 5 6 129 5 6 9 4 7 5 6 15 
17 0 0 0 0 0 0 0 0 0 0 0 129 0 0 0 0 0 0 0 0 0 0 129 0 0 0 0 0 0 0 31 
33 0 0 0 0 97 98 98 98 98 98 98 97 97 98 98 97 98 98 98 98 98 98 97 98 98 98 98 98 98 97 47 
49 0 0 0 0 129 0 0 0 0 0 0 0 129 0 0 129 0 0 0 0 0 0 0 0 0 0 28 29 30 129 31 
17 0 0 0 0 129 0 0 0 0 0 0 0 129 0 0 129 0 0 0 0 0 0 0 0 0 0 44 45 46 129 47 
33 0 37 38 39 129 37 38 39 0 37 38 39 129 0 0 129 0 0 0 0 0 0 0 0 0 0 60 61 62 129 63 
49 0 53 54 55 129 53 54 55 0 53 54 55 129 0 151 145 146 147 148 149 148 149 148 149 150 151 76 77 78 145 79 
65 67 69 70 71 145 69 70 71 67 69 70 71 145 146 167 129 162 163 164 165 164 165 164 165 166 167 8 5 6 129 15 
1 7 5 6 4 129 5 6 5 6 8 4 9 129 162 0 129 0 0 0 0 0 0 0 0 0 0 24 0 0 129 31 
17 0 0 0 0 129 0 0 0 0 24 0 0 129 0 0 97 98 98 98 98 97 0 0 37 38 39 24 0 0 129 47 
33 0 0 0 0 129 0 0 0 0 24 0 0 129 0 0 0 0 0 0 0 129 0 0 53 54 55 24 0 0 129 31 
49 0 0 0 0 113 0 0 0 0 24 0 0 129 0 0 0 0 0 0 0 129 0 151 69 70 71 72 146 0 129 31 
17 0 0 0 0 129 0 0 151 67 72 67 146 129 0 0 0 0 0 0 0 113 0 15 1 4 4 4 162 0 129 47 
33 0 0 0 0 129 0 0 15 1 9 9 162 129 0 0 0 0 0 0 0 129 0 31 17 0 0 0 0 0 129 31 
49 0 0 0 0 129 0 0 31 17 0 0 0 113 0 0 0 0 0 0 0 129 0 47 49 0 0 0 0 0 129 47 
49 0 0 0 0 113 0 0 47 49 0 0 0 129 0 0 0 18 19 20 0 113 0 63 33 0 0 0 0 0 129 63 
17 37 38 39 0 129 0 0 63 33 0 0 0 129 0 0 0 34 35 36 0 129 0 31 17 0 0 0 0 0 129 47 
33 53 54 55 0 129 0 0 31 17 0 0 0 113 0 0 0 50 51 52 0 129 0 47 17 0 0 0 0 0 113 63 
65 69 70 71 146 129 0 0 47 17 0 0 0 129 0 0 0 66 67 68 0 129 0 63 33 0 0 0 151 67 145 79 
1 4 5 6 162 129 0 0 63 33 0 0 0 129 0 0 0 8 5 6 0 129 0 63 49 0 0 0 167 9 129 15

1 4 5 6 7 8 9 17 33 49 64 65 80 162 -1

4 5 6 7 8 9 15 31 47 63 64 79 80 167 -1

64 65 66 67 68 69 70 71 72 73 74 75 76 77 78 79 80 102 103 146 147 148 149 150 151 93 94 -1

1 4 5 6 7 8 9 15 64 80 162 167 -1 

24 72 -1

8 24 -1

61 -1





