TILEMAP
32 20 
16 16 
images/tilesetGooniesRed.png 
16 16 
7 5 6 4 9 7 4 9 5 6 7 7 9 4 5 6 129 9 4 9 5 6 7 4 5 6 9 4 5 6 7 15 
0 0 0 0 28 29 30 0 0 0 0 0 0 0 0 0 129 0 0 0 83 84 85 0 0 0 0 0 18 19 20 31 
0 0 0 0 44 45 46 0 0 0 37 38 39 0 0 0 129 0 0 0 99 100 101 0 0 0 0 0 34 35 36 47 
0 0 0 0 60 61 62 0 0 0 53 54 55 0 0 0 113 0 0 0 0 0 0 0 0 0 0 0 50 51 52 63 
67 67 67 67 76 77 78 67 67 67 69 70 71 67 67 67 145 67 67 67 67 67 67 67 67 67 67 67 66 67 68 79 
9 5 6 4 9 4 7 4 5 6 15 1 4 8 5 6 129 4 5 6 7 4 9 7 5 6 9 5 6 8 7 15 
0 0 0 0 0 0 0 0 0 0 31 17 0 24 0 0 97 98 98 98 98 98 97 0 28 29 30 0 0 24 0 31 
0 0 0 0 0 0 0 0 0 0 47 33 0 24 0 0 129 0 37 38 39 0 129 0 44 45 46 0 0 24 0 47 
0 0 0 0 0 0 0 0 0 0 63 49 0 24 0 0 113 0 53 54 55 0 113 0 60 61 62 0 0 24 0 63 
0 0 0 0 0 0 0 0 0 0 63 65 67 72 67 67 145 67 69 70 71 67 145 67 76 77 78 67 67 72 67 79 
67 67 146 0 0 0 0 0 0 0 0 5 6 9 4 5 129 7 9 7 5 6 129 4 7 9 5 6 7 5 6 15 
64 80 1 0 0 0 0 0 0 0 0 0 0 0 0 0 129 0 0 0 0 0 129 0 0 0 0 0 0 0 0 31 
80 64 65 67 146 0 0 0 0 0 0 0 0 0 0 0 129 0 0 0 0 0 129 0 0 0 0 0 37 38 39 47 
80 64 80 80 1 0 0 0 0 0 18 19 20 0 0 0 113 0 0 0 0 0 129 0 0 0 0 0 53 54 55 63 
64 80 64 80 65 67 146 0 0 0 34 35 36 0 0 0 129 148 150 150 0 0 113 0 0 0 0 151 69 70 71 79 
64 80 80 64 80 64 1 0 0 0 50 51 52 0 0 0 129 163 165 166 0 0 129 147 148 0 0 167 5 6 4 162 
80 64 64 80 80 80 65 67 67 67 66 67 68 67 146 0 129 0 0 0 0 0 129 163 166 0 0 0 0 0 0 0 
80 64 80 80 80 64 80 80 64 80 64 80 64 64 1 0 129 0 0 0 0 0 129 0 0 0 0 0 0 0 0 0 
96 95 96 95 95 96 96 95 96 95 95 96 96 95 96 93 93 94 94 93 94 93 93 94 94 93 94 93 94 93 93 93 
93 93 94 94 93 94 93 93 94 94 93 94 93 93 93 94 93 93 94 94 93 94 93 93 94 94 93 93 93 94 94 93

1 4 5 6 7 8 9 17 33 49 64 65 80 162 -1

4 5 6 7 8 9 15 31 47 63 64 79 80 167 -1

64 65 66 67 68 69 70 71 72 73 74 75 76 77 78 79 80 102 103 146 147 148 149 150 151 93 94 -1

1 4 5 6 7 8 9 15 64 80 162 167 -1 

24 72 -1

8 24 -1

61 -1





