TILEMAP
32 20 
16 16 
images/tilesetGooniesGreen.png 
16 16 
64 64 64 64 64 64 64 64 64 64 64 64 64 64 64 1 162 0 0 129 0 24 0 0 129 0 0 0 0 24 0 31 
64 64 64 64 64 64 64 64 64 64 64 64 64 64 64 17 0 0 0 113 0 24 0 0 129 0 0 0 0 24 0 47 
64 64 64 64 64 64 64 64 64 64 64 64 64 64 64 33 0 0 0 129 0 24 0 0 129 0 0 0 0 24 0 63 
64 64 64 64 64 64 64 64 64 64 64 64 64 64 64 65 67 146 0 113 0 24 15 1 129 0 0 0 0 24 0 47 
1 5 6 7 9 129 5 6 4 7 5 6 9 4 5 80 64 1 0 129 0 24 63 17 129 0 0 0 0 24 0 31 
17 28 29 30 0 129 0 0 0 0 0 0 0 0 0 15 64 33 0 113 0 24 47 33 129 0 0 0 0 24 0 31 
33 44 45 46 0 129 0 0 0 0 0 0 0 0 0 63 80 49 0 129 0 24 63 17 129 0 37 38 39 24 0 47 
49 60 61 62 0 113 0 0 0 0 0 0 0 0 0 0 9 0 0 113 0 24 47 33 129 54 53 54 55 24 0 63 
65 76 77 78 67 145 67 67 67 67 67 67 146 0 0 0 0 0 0 129 0 24 47 65 145 70 69 70 71 72 67 79 
1 5 6 7 5 6 4 8 9 7 5 6 162 0 0 18 19 20 0 113 0 24 0 167 129 4 9 162 4 5 6 7 
17 0 0 0 0 0 0 24 0 0 0 0 0 0 0 34 35 36 0 129 0 24 0 0 113 0 0 0 0 0 0 0 
33 37 38 39 0 0 0 24 0 0 0 0 0 0 0 50 51 52 0 113 0 24 0 0 129 0 0 0 0 0 0 0 
49 53 54 55 0 0 0 24 0 0 0 0 0 0 151 66 67 68 146 129 0 24 0 0 113 0 0 0 0 0 0 0 
65 69 70 71 146 0 0 24 0 0 0 0 0 0 167 4 5 6 162 113 0 24 0 0 129 0 0 18 19 20 0 0 
1 5 6 4 162 0 0 24 0 0 0 0 0 0 0 0 0 0 0 129 0 24 0 0 113 0 0 34 35 36 0 0 
17 0 0 0 0 0 0 24 0 0 0 0 0 37 38 39 0 0 0 113 0 24 0 0 129 0 0 50 51 52 0 0 
33 0 0 0 0 0 0 24 0 0 0 0 0 53 54 55 0 0 0 129 0 24 0 0 113 151 67 66 67 68 67 67 
49 0 0 0 0 0 0 24 0 0 0 0 151 69 70 71 146 0 0 113 0 24 0 0 129 167 7 5 6 9 7 4 
65 67 67 67 67 67 67 72 146 0 0 0 167 7 4 9 162 0 0 129 0 24 0 0 113 0 0 0 0 0 0 0 
1 9 4 7 5 6 9 4 162 0 0 0 0 0 0 0 0 0 0 113 0 24 0 0 129 0 0 0 0 0 0 0

1 4 5 6 7 8 9 17 33 49 64 65 80 162 -1

4 5 6 7 8 9 15 31 47 63 64 79 80 167 -1

64 65 66 67 68 69 70 71 72 73 74 75 76 77 78 79 80 102 103 146 147 148 149 150 151 93 94 -1

1 4 5 6 7 8 9 15 64 80 162 167 -1 

24 72 -1

8 24 -1

61 -1





