TILEMAP
32 20 
16 16 
images/tilesetGooniesYellow.png 
16 16 
33 0 0 0 0 0 0 0 0 0 0 0 0 129 63 64 33 0 0 0 0 0 0 31 17 0 0 0 0 129 0 63 
17 0 0 0 0 0 0 0 0 28 29 30 0 129 47 80 17 0 0 0 0 0 0 63 33 0 0 0 0 129 0 31 
49 0 0 0 0 0 0 0 0 44 45 46 0 129 63 64 17 0 0 0 0 0 0 31 17 0 0 0 0 113 0 47 
33 0 0 0 0 0 0 0 0 60 61 62 0 129 63 80 17 0 0 0 0 0 0 47 65 67 67 146 0 129 0 63 
17 0 0 0 0 0 0 0 0 76 77 78 0 129 47 64 17 0 0 0 0 0 0 47 1 5 6 162 0 129 0 63 
17 0 0 0 0 0 0 0 0 83 84 85 0 113 31 80 33 0 0 0 0 0 0 31 17 0 0 0 0 113 0 47 
33 18 19 20 0 0 0 0 0 99 100 101 0 129 37 38 39 0 0 0 151 67 67 79 17 0 0 0 18 19 20 31 
49 34 35 36 0 0 0 0 0 0 0 0 0 113 53 54 55 0 0 0 167 4 5 64 33 0 0 0 34 35 36 31 
49 50 51 52 0 0 0 0 0 0 0 0 0 129 99 70 101 0 0 0 0 0 0 63 33 0 0 0 50 51 52 47 
65 66 67 68 146 0 0 0 0 0 0 0 0 129 0 164 0 0 0 0 0 0 0 47 17 0 0 151 66 67 68 79 
1 5 6 9 162 0 0 0 0 0 0 0 0 129 0 0 0 0 83 84 85 0 0 31 17 0 0 167 167 129 5 64 
17 0 0 0 0 0 0 0 0 0 0 0 0 97 98 97 98 98 99 100 101 0 0 47 33 0 0 0 0 129 0 31 
33 37 38 39 0 0 0 0 0 0 0 0 0 0 0 129 0 0 0 0 0 0 0 0 0 0 0 0 0 129 0 31 
49 53 54 55 0 0 0 0 0 0 0 0 0 0 0 129 0 0 0 0 0 0 0 0 0 0 0 0 0 129 0 63 
65 69 70 71 0 0 0 0 0 0 0 0 0 0 0 129 0 0 0 0 0 0 0 0 0 0 0 0 0 129 0 31 
1 5 6 7 0 28 29 30 0 0 0 0 0 0 0 113 0 149 149 0 0 0 0 0 0 25 26 27 0 129 0 47 
17 0 0 0 0 44 45 46 0 0 0 0 149 0 0 129 0 165 165 0 0 0 0 0 0 41 42 43 0 129 0 47 
17 0 0 0 0 60 61 62 0 0 0 0 165 0 0 129 0 0 0 0 0 0 0 0 0 57 58 59 0 129 0 63 
33 0 0 0 151 76 77 78 146 0 0 0 0 0 0 129 0 0 0 0 0 0 151 67 67 73 74 75 67 145 67 79 
95 94 93 94 96 96 95 95 96 93 94 94 93 93 93 93 94 93 93 93 93 94 96 95 96 96 95 96 95 96 95 95

1 4 5 6 7 8 9 17 33 49 64 65 80 162 -1

4 5 6 7 8 9 15 31 47 63 64 79 80 167 -1

64 65 66 67 68 69 70 71 72 73 74 75 76 77 78 79 80 102 103 146 147 148 149 150 151 93 94 -1

1 4 5 6 7 8 9 15 64 80 162 167 -1 

24 72 -1

8 24 -1

61 -1





