TILEMAP
32 20 
16 16 
images/tilesetGooniesRed.png 
16 16 
64 80 64 80 64 80 64 80 80 64 80 80 64 64 80 64 80 64 80 64 80 64 6 7 5 6 9 4 129 5 6 7 
64 80 80 64 64 80 80 64 64 80 80 64 64 64 80 80 64 83 84 85 64 1 0 0 0 0 0 0 129 0 0 0 
6 7 4 9 4 5 6 9 5 6 9 5 64 80 64 80 64 99 100 101 80 17 0 37 38 39 0 0 129 0 0 0 
0 0 0 0 0 0 0 0 0 0 0 0 4 7 15 64 80 80 64 80 64 33 0 53 54 55 0 0 113 0 0 0 
0 0 0 0 0 37 38 39 0 0 0 0 0 0 0 7 15 64 80 80 64 65 67 69 70 71 67 67 145 67 67 67 
0 0 0 0 0 53 54 55 0 0 0 0 0 0 0 0 0 9 129 4 9 5 6 4 7 9 5 6 129 7 4 9 
67 67 67 67 67 69 70 71 67 146 0 0 0 0 0 0 0 0 97 98 98 98 98 98 98 98 98 98 97 0 0 0 
4 5 6 7 9 5 6 7 15 1 0 0 0 0 0 0 0 0 129 0 0 0 0 28 29 30 0 0 129 0 0 0 
0 0 0 0 18 19 20 0 31 17 0 0 0 0 0 0 0 0 129 0 0 0 0 44 45 46 0 0 129 0 0 0 
0 0 0 0 34 35 36 0 47 33 0 0 0 25 26 27 0 0 129 0 0 0 0 60 61 62 0 0 129 0 0 0 
0 0 0 0 50 51 52 0 63 33 0 0 0 41 42 43 0 0 129 0 151 67 67 76 77 78 67 67 145 67 67 67 
67 67 67 67 66 67 68 67 79 17 0 0 0 57 58 59 0 0 129 0 167 5 64 6 7 5 6 7 4 5 6 15 
80 64 80 80 64 6 7 4 9 0 0 151 67 73 74 75 146 0 129 0 0 0 8 0 0 0 0 0 0 0 0 47 
7 5 6 5 1 0 0 0 0 0 0 167 8 9 5 6 162 0 129 0 0 0 24 0 0 0 0 0 0 0 0 63 
0 0 0 0 0 0 0 0 0 0 0 0 24 0 0 0 0 0 129 0 0 0 24 0 0 0 0 18 19 20 0 31 
0 0 37 38 39 0 0 0 0 0 0 0 24 0 0 0 0 0 129 0 0 0 24 0 0 0 0 34 35 36 0 47 
0 0 53 54 55 0 0 0 0 0 0 0 24 0 0 0 0 0 129 0 0 0 24 0 0 0 0 50 51 52 0 63 
67 67 69 70 71 67 146 0 0 0 151 67 72 146 0 0 0 0 129 0 0 0 0 0 151 67 67 66 67 68 67 79 
80 64 64 80 64 80 64 93 94 93 95 95 96 95 93 93 94 93 94 94 93 94 93 93 95 96 95 96 96 95 95 96 
80 80 64 80 64 80 80 93 94 94 93 93 94 94 93 93 93 94 93 93 93 94 94 93 93 93 93 94 93 94 94 93

1 4 5 6 7 8 9 17 33 49 64 65 80 162 -1

4 5 6 7 8 9 15 31 47 63 64 79 80 167 -1

64 65 66 67 68 69 70 71 72 73 74 75 76 77 78 79 80 102 103 146 147 148 149 150 151 93 94 -1

1 4 5 6 7 8 9 15 64 80 162 167 -1 

24 72 -1

8 24 -1

61 -1





