TILEMAP
32 20 
16 16 
images/tilesetGooniesPurple.png 
16 16 
6 5 6 7 9 4 7 9 5 6 4 7 4 5 6 7 4 5 6 15 1 5 6 7 9 5 64 6 5 6 7 15 
17 0 25 26 27 0 0 0 0 0 0 0 0 0 0 0 0 0 0 47 17 0 0 0 0 0 8 0 0 0 0 31 
33 0 41 42 43 0 0 0 0 0 0 0 0 0 0 18 19 20 0 31 17 0 0 0 0 0 24 0 0 0 0 47 
49 0 57 58 59 0 0 0 0 0 0 0 0 0 0 34 35 36 0 47 33 0 37 38 39 0 24 0 0 0 0 63 
65 149 73 74 75 148 149 67 149 0 0 0 0 0 0 50 51 52 0 63 49 0 53 54 55 0 24 0 0 0 0 31 
9 163 165 4 166 163 7 9 8 0 0 0 0 147 148 66 67 68 147 79 65 147 69 148 71 146 24 0 0 0 0 47 
0 0 0 0 0 0 0 0 24 0 0 0 0 163 165 164 9 7 166 0 0 167 9 163 166 164 24 0 0 0 0 63 
0 0 0 0 0 0 0 0 24 0 0 0 0 0 0 0 0 0 0 0 0 0 0 0 0 0 24 0 0 0 0 31 
0 0 0 0 0 0 0 0 24 0 0 0 0 37 38 39 0 0 0 0 0 0 0 0 0 0 24 0 0 0 0 47 
0 0 0 0 0 0 0 0 0 0 0 0 0 53 54 55 0 0 0 0 0 0 0 0 0 0 24 0 0 0 0 63 
147 67 147 147 148 67 67 147 0 0 0 0 151 69 149 71 146 0 0 0 0 0 0 0 0 0 24 0 0 0 0 31 
9 166 163 7 4 165 8 162 0 0 0 0 164 163 165 166 162 0 0 0 0 0 28 29 30 0 24 0 0 0 0 47 
98 98 98 98 97 0 24 0 0 0 0 0 0 0 0 0 0 0 0 0 0 0 44 45 46 0 24 0 0 0 0 63 
0 0 0 0 129 0 24 0 0 0 0 0 0 0 0 0 0 0 0 0 0 0 60 61 62 0 24 0 0 0 0 31 
0 0 0 0 129 0 24 0 0 0 0 0 0 0 0 37 38 39 0 0 0 147 76 149 78 148 24 0 0 0 0 47 
0 0 0 0 129 0 24 0 0 0 0 0 0 0 0 53 54 55 0 0 0 165 164 167 165 166 24 0 18 19 20 63 
0 0 0 0 113 0 24 0 0 0 0 0 0 0 147 69 147 71 146 0 0 0 0 0 0 0 24 0 34 35 36 31 
0 0 0 0 129 0 24 0 0 0 0 0 0 0 167 163 166 9 165 0 0 0 0 0 0 0 24 0 50 51 52 47 
0 0 0 149 145 67 72 149 148 0 0 0 0 0 0 0 0 0 0 0 0 0 0 0 0 0 0 151 66 67 68 79 
93 94 93 95 96 95 95 95 96 94 94 93 93 94 93 93 94 94 93 93 94 93 93 94 93 93 94 95 95 96 95 96

1 4 5 6 7 8 9 17 33 49 64 65 80 162 -1

4 5 6 7 8 9 15 31 47 63 64 79 80 167 -1

64 65 66 67 68 69 70 71 72 73 74 75 76 77 78 79 80 102 103 146 147 148 149 150 151 93 94 -1

1 4 5 6 7 8 9 15 64 80 162 167 -1 

24 72 -1

8 24 -1

61 -1





