TILEMAP
32 20 
16 16 
images/tilesetGooniesBlue.png 
16 16 
1 4 9 5 6 7 15 64 1 83 84 85 98 97 0 24 0 0 0 47 33 24 97 98 98 83 84 85 0 0 24 15 
17 0 0 0 0 0 0 8 0 99 100 101 0 8 0 24 0 8 0 63 49 24 129 8 0 99 100 101 0 0 24 31 
17 0 18 19 20 0 0 24 0 24 0 8 0 24 0 24 0 24 0 79 65 24 113 24 0 0 24 0 0 0 24 47 
33 0 34 35 36 0 0 24 0 24 0 24 0 24 0 24 0 24 0 9 4 24 129 24 0 0 24 0 0 8 24 31 
49 0 50 51 52 0 0 24 0 24 0 24 0 24 0 24 37 38 39 0 0 24 129 24 0 8 24 0 0 24 24 47 
65 67 66 67 68 67 146 24 0 24 0 24 0 24 0 24 53 54 55 0 8 24 129 24 0 24 24 0 0 24 24 63 
9 4 5 6 7 4 162 0 0 24 0 24 0 24 0 151 69 70 71 146 24 0 129 24 0 24 0 0 0 24 0 47 
0 0 0 0 0 0 0 0 0 24 0 24 83 84 85 167 8 5 6 8 24 0 129 24 0 24 0 0 0 24 0 31 
0 0 0 0 0 0 0 0 8 24 0 24 99 100 101 0 24 0 0 24 0 0 113 24 0 24 8 0 0 24 0 63 
67 67 67 67 67 67 146 0 24 0 0 24 0 8 0 0 24 0 0 24 83 84 85 24 0 0 24 0 0 24 0 47 
1 4 9 5 6 7 162 0 24 0 8 24 0 24 0 0 24 0 0 24 99 100 101 24 0 0 24 0 18 19 20 31 
33 0 0 0 0 0 0 0 24 0 24 24 0 24 0 0 24 0 0 0 0 8 0 24 0 0 24 0 34 35 36 47 
17 0 0 0 0 0 0 8 24 0 24 24 0 24 0 0 24 0 0 0 0 24 0 0 0 0 24 0 50 51 52 63 
17 0 0 0 0 0 0 24 24 0 24 24 0 24 0 0 24 0 0 0 0 24 0 0 0 0 24 151 66 67 68 79 
49 0 37 38 39 0 0 24 0 0 24 0 0 0 0 0 24 0 0 8 0 24 0 0 0 0 24 8 7 9 5 6 
17 0 53 54 55 0 0 24 0 0 24 37 38 39 0 8 24 0 0 24 0 24 37 38 39 0 24 24 0 0 0 0 
33 151 69 70 71 146 0 24 0 0 24 53 54 55 0 24 24 0 0 24 0 24 53 54 55 0 0 24 0 0 0 0 
49 167 5 6 7 162 0 0 0 0 151 69 70 71 146 24 0 0 0 24 0 151 69 70 71 146 0 24 0 0 0 0 
65 0 0 0 0 0 0 0 0 0 167 7 5 6 162 0 0 0 0 0 0 167 7 5 6 162 0 0 0 0 0 0 
96 93 93 94 93 94 93 93 94 93 93 94 93 93 94 93 94 94 93 93 93 93 94 94 93 94 93 93 94 93 94 93

1 4 5 6 7 8 9 17 33 49 64 65 80 162 -1

4 5 6 7 8 9 15 31 47 63 64 79 80 167 -1

64 65 66 67 68 69 70 71 72 73 74 75 76 77 78 79 80 102 103 146 147 148 149 150 151 93 94 -1

1 4 5 6 7 8 9 15 64 80 162 167 -1 

24 72 -1

8 24 -1

61 -1





